▶️ kolory - coleur
nox - niebieski
cheld - zielony
nab - żółty
bras - pomarańczowy
card - czerwony
nec - biały
cieur - czarny 
neuv - ciemny
ran - jasny 
▶️ id vassanu
para - odpowiedni, poprawny
tauv - dobry  [teuv teuven teuvas] 
fam - zły
faed, rig - szybki
meana - ciekawy
saega - użyteczny
laga - śmieszny
naèc - poważny
avra - prawdziwy (neazabro? / abraú?)
faeca - fajny
seuiga - łatwy
sod - lekki/łatwy
thar - ciężki
jeus - trudny
complex - skomplikowany
necheas, nes - następny
pag - póżny
ches - wczesny
laes - ostatni
preva - poprzedni
gels - mały
nog - duży
eges - cały
reuz - silny
sag - słaby
dauv - długi
carta - krótki
riez - różny
riven - równy
gelca - szczęśliwy, wesoły
jal - smutny
fand - ważny
norna - do zrobienia
ilverna - niewiarygodny
saurna - zrozumiały
eusta - szczery
setra - dawny
pata - tani
vasca - fałszywy
ciana - wspólny
thag - darmowy 
pra - nowy
sauj - podobny
cej - dokładnie, ceja - dokładny
gar - ładny
sen - sam, samemu
vraes - pewny [vraesaū - prawdopodobnie, pewnie]
smeca - smaczny
lan - zimny
valen, led - wolny
avresenca - prawdopodobny
nej - niski
suvena - piękny
fardae - zmęczony
duv - gotowy, gotów
ful - leniwy
nusid - jedyny
savesca - ogólny
mescaena - różnorodny
sner - pełny 
bel - dziwny
vilca - randomowy, losowy
smienc - miły
sagala - oczywisty
cejvesca - szczególny (besonders)
cejnasa - szczegółowy
navvesca - publiczny 
