▶️ Iu - ludzie
sac - mężczyzna
mae - kobieta
faurū - kolega
daec - chłopak
mé - dziewczyna
sautū - dziecko
breur - brat
sveur - siostra
mamū - mama
papū - tata
babū - babcia
dadū - dziadek
thatic - ciocia
vusic - wujek
stacsen - nauczyciel
rovsen - wykładowca
rovas - student
stacas - uczeń
senoc - osoba 
▶️ Eucmantū - transport
citū - pociąg
bus, dauvas - autobus
vagū - auto
vealū - rower
gearcias - przystanek
citcias - dworzec kolejowy
buscias - dworzec autobusowy
cialie - bilet 
▶️ GEDONT - PAŃSTWA
Etcas - Eteja
Polencas - Polska [Polen/Polences - polski]
Doecas - Niemcy [Doeces - niemiecki]
Belgis - Belgia [Belgsa - belgijski]
Necralis - Niederlandy, Holandia [Necralsa - niderlandzki, holenderski]
Eucraenū - Ukraina [Eucraenam - ukraiński]
Italis - Włochy [Italsa - włoski]
Francas - Francja [Frances - francuski]
Cispanis - Hiszpania [Cispansa - hiszpański]
Celadis - Grecja [Celadsa - grecki]
Rosis - Rosja [Rossa - rosyjski]
Sevedcas - Szwecja [Sevedces - szwedzki]
Norvegis - Norwegia [Norvegsa - norweski]
Ircas - Irlandia [Irces - irlandzki]
Sevis - Szwajcaria [Sevsa - szwajcarski]
Eustearis - Austria [Eustearsa - austriacki]
Nogbritanis - Wielka Brytania [Britansa - brytyjski]
Portugalū - Portugalia [Portugalam - portugalski]
Teurcis - Turcja [Teurcsa - turecki]
Romanis - Rumunia [Romansa - rumuński]
Necrosis - Białoruś [Necrossa - białoruski]
Estoncas - Estonia [Estonces - estoński]
Slovencas - Słowacja [Slovences - słowacki]
Magarcas - Węgierski [Magar, Magarces - węgierski]
Seuyetae Candū Nameriecū, SCN - USA, Stany Zjednoczone [SC-Ameriecam - amerykański]
Sina - Chiny [Sinam - chiński]
Indis - Indie [Indsa - indyjski]
Braziel - Brazylia [brazielam - brazylijski]
▶️ Continentū i s'sauj - Kontynenty itp.
Eūropea - Europa [Eūropeasam - europejski]
Eūropeasam Unis - Unia Europejska
Ameriecū - Ameryka [Ameriecam - amerykański] 
▶️ Formū i casvauris - Kształty i geometria
koło - bear
kwadrat - rens 
▶️ Antanoc - Materiały
aezoc - metal [aezuc - metalowy]
drevoc - drewno
cunstoc - plastic
linsoc - papier
cidroc - wodór
oxegoc - tlen 
▶️ Części ciała
galf - głowa
adnas - mózg
paeser/sem - oko, oczy
recas - nos
reul - twarz
ram - ręka
ceurs - dłoń
leb - stopa 
▶️ Itgalis i itstacis - lingwistyka i nauka języków
itū - język
cū - słowo
menas - litera 
▶️ Pajū - jedzenie
aemū  - jabłko
mius - mleko
braut - chleb
voedū - woda
pomodorū - pomidor
sausū - sos
leūcic, supū - zupa
onen - cebula 
▶️ Caenid - Bez kategorii
caèlū - niebo
geulū - piekło
itū - język/mowa
nemū - imię/nazwa
beat - rok
pres - sposób
seur - czas
sintū - powód
nivū - poziom
nitū - pokój
cheftū - ruch
ach - dzień
man - miejsco
gedū - państwo
garo - kraj
chardie - pieniądze
dan - rzecz
sonū - dom
dragū - droga
asterū - gwiazda
aset - miasto
cū - słowo
prat - świat
meanū - zainteresowanie
meanoc - ciekawostka
smidū - dowód
stacis - nauka
nadū - nadzieja
verū - faith
avrū - prawdza
paveasasc - uważność
cavel - kawałek
stedū - strona
chadū - cień
scesū - obraz
caenū - rodzaj
sapū - cisza
feurū - ogień
linū - strach
axer - urządzenie
chevaxer - urządzenie mobilne
berū - ubranie
sauris - inteligencja 
fincū - chwila
medū  - środek 
lunū - księżyc 
blat - liść 
taethis - pogoda
miscū - spokój
nascitū - napięcie
drevcas - las
liscū - piosenka
roesis - muzyka
jeunciatū - postęp 
navces - drzwi 
citcias - dworzec
riezetū - pochodna
egesic - całka 
fald - pole
adis - umysł 
reuvgantū - telewizja
reuvganer, RG, paesie - telewizor
reues - prawo, zasada
stacie - lekcja
vardū - wartość 
foc - typ, ziom, gostek
iuces - populacja, ludność 
iusis - ludzkość
ceudū - problem
danie - temat
scitū - część
scitsen - członek 
seces - grupa
meslejū - układ, layout
axis - firma
maūt - śmieć, śmieci
maūtnas - śmietnik
dajis - kolejność
seuroc - moment
vilcu - los
gasū - głos
stacdan - przedmiot szkolny/uczelniany
mald - sens
fincū - moment chwila
molcias - kościół
lastach - plecak
besū - cena
danse - wiązać [zadansae - powiązany] 
