▶️ Particles prepositions etc.
i - i
det - a
chac - ale
meas - nawet
ém - dla
or - już
je - jeszcze
umae - znowu
maès - nadal
aúris - o (about a topic)
arys - tylko
aval - prawie
pris - czy?
mich - zamiast
acos - pomimo
ceunaū - właściwie/eigentlich
avies - przeciw, przeciwko
rean - wobec
noe - przez
id - bez
viscaū - może
cod, riv - też
jencaū - właściwie 
valen - chyba
reuvan - dalej [reuv - daleki]
avrūsenca - prawdopodobny 
naū - jako
naūdis - w ogóle
michet - tylko (sondern)
dismich - a nie
▶️ Miscancelaneous
Dis - nie
Gen - tak
chan - trochę
▶️ Filler words
so... - nooo...
va.../deva.../vava... - ten teges
deus - cóż...
eustaū iteno - szczerze powiedziawszy
vesciu - mam na myśli, I mean
an saetū - w sensie
▶️ S'sanete seur - Descriptions of time
seur - czas
ad - since / od
nae - until / do
neu chas aúris - two weeks ago
jeun - przed
léz - po
greas - teraz
▶️ Diuvasc - Częstotliwość
sacam - zawsze
normaū - zazwyczaj
diuvaū  - często
seuru - czasem
iliaū - nigdy
citaū - ciągle
necaū - rzadko
▶️ Seueces neseur - Jednostki czasu
beatpar - dekada
beat - rok
mesit - miesiąc 
chascansū - weekend
chas - tydzień 
ach - dzień
notū - noc
daevū - godzina
minutū - minuta
second - sekunda
▶️ Mesit - miesiące
deces - styczeń
dreusnas - luty
breznas - narzec
cevitces - kwiecień
mayus - maj
cardnas - czerwiec
julie - lipiec


▶️ Ach niechas
lunnas - poniedziałek
dinnas - wtorek
chasmed - środa
richnas - czwartek
gaurnas - piątek
thernas - sobota
cansces - niedziela
▶️ Beatseur - pory roku
vencū - wiosna
lincū - lato
blatnas - jesień
lances - zima
▶️ Pozdrowienia
Tauv ach ! - Dzień dobry!
Tauv nottot ! - Dobranoc! 
Nae s'miels ! - Do widzenia! 
Asprathiu, sprathiu - przepraszam
Giriu/gir's - dziękuję/dzięki
Cae ! - Hej! 
Samot tauvas ! - Wszystkiego najlepszego! 
▶️ Prepositions
alt - ponad
tev - pod
las - za czymś
jeun - przed
in - między
spen - dookoła
casp - poza
tac - obok
reues - prawo
lenc - lewo
asū - góra
as - na górze czegoś
utū - dół
ut - na dole

an   ¦ en     ¦ es   -    w 
éz    ¦ nas   ¦ zén -     na (horizontal)
az    ¦ nas   ¦ zan -     na (vertical) 
vé    ¦ vas   ¦ zav -      przy 
