▶️ LISPEN - KOLOR
violet - fioletowy
nyx - niebieski
šeld - zielony
nab - żółty
bras - pomarańczowy
kard - czerwony
nek - biały
kiyr - czarny 
nyv - ciemny
ran - jasny 
lang - szary
siaž - różowy
rând - brązowy
noganna - przezroczysty
lispena - kolorowy
klära - złoty
argenta - srebrny
▶️ SMEKENT - SMAKI
miei - słodki, uroczy [mieity - słodycz, miejesk - słodkość, słodycz]
sala - słony
umami - umami
orsa - gorzki [oris - gorycz]
géd, picant - ostry, pikantny
▶️ ID VASSANTY
tâv - dobry  [tyv tyven tyväs] 
fam - zły
faid, rig - szybki
mäna - ciekawy
saiga - użyteczny
laga - śmieszny
näik - poważny
avra - prawdziwy
avra - prawdziwy
bel - dziwny
blas - płaski
blek - gęsty
bond - mądry
byn - równy
bäin - biedny
dies - wąski
diuva - częsty
driek - stary
dräi - mokry
duv - gotowy, gotów
dâv - długi
egs - cały
faid, rig - szybki
faika - fajny
fam - zły
fand - ważny
fardai - zmęczony
fieš - prosty (np. linia)
flap - grzeczny
ful - leniwy
fäl - wolny, frei
gar - ładny
gač - gorący
gelka - szczęśliwy, wesoły
gels - mały
gom - brzydki
hain - głośny
heik - uroczy
hyt - suchy
illig - niebezpieczny
ilverna - niewiarygodny
ilversat - małowierny
karta - krótki
kež - dokładnie, ceja - dokładny
keždatai - konkretny
kežnasa - szczegółowy
kežveska - szczególny (besonders)
kiana - wspólny
komplex - skomplikowany
käider, lagvarda - żałosny
laga - śmieszny
lais - ostatni, końcowy
lan - zimny
led - wolny
leig - poprzedni, ostatni
lig - bezpieczny
läis - młody
meda {Aizokis Meda} - środkowy, centralny {Aizokis Główny}
medveska - średni, average
meskaina - różnorodny
meu - ciepły
mäna - ciekawy
nais - bogaty
navveska - publiczny
nešäs, nes - następny
než - niski
nog - duży
noika - przyjemny
norna - do zrobienia
nusid - jedyny
näik - poważny
nät - uporządkowany, aufgeräumt
pag - póżny
para - odpowiedni, poprawny
paral - sprawiedliwy
pata - tani
pra - nowy
praveska - oryginalny (originell)
preg - pusty #empty
raf - czysty
riez - różny
roi - wielki
ryz - silny
râd - gruby
sag - słaby
sagala - oczywisty
saiga - użyteczny
saveska - ogólny
sen - sam, samemu
senal - samotny
setra - dawny
sevota - wzajemny [sevotaū - nawzajem]
siuglama - przeterminowany
smeka - smaczny
smienk - miły
sner - pełny
sod - lekki, łatwy
som - stały #stale
steu - dumny
sund - szeroki
suvena - piękny
suveska - oryginalny (original)
suvräin - niesamowity, awesome
syiga - łatwy
sârna - zrozumiały
tâv - dobry  [tyv tyven tyväs]
vajan - raczej
vaska - fałszywy
vien - cienki, chudy
vilka - randomowy, losowy
vrais - pewny [vraisau - na pewno, pewnie]
vrav - podobny
ysta - szczery
âtsenka - alternatywny
čah, šardid - darmowy, bezpłatny
čar - ciężki
šes - wczesny
šiala - szalony
žal - smutny
žys - trudny
