▶️ IU - LUDZIE
sak - mężczyzna
maj - kobieta
fâr - kolega
daik - chłopak
mé - dziewczyna
sâty - dziecko
bryr - brat
sevyr - siostra
mam - mama
pap - tata
bab - babcia
dad - dziadek
čantik - ciocia
gašog - wujek
staksen - nauczyciel
rovsen - wykładowca
rovas - student
stakas - uczeń
senok - osoba 
kianis - społeczeństwo
▶️ DEGITY - ZAWODY
roksen - kasjer
liosmetas - sprzedawca
baitas - piekarz
bykhaudas - księgowy [Beucgaūdis - księgowość]
mautsen - śmieciarz
nätsen - sprzątaczka
rytas - badacz
atas - filozof, myśliciel
hadas - kucharz
šelas - pomocnik, asystent
▶️ EUCMÉNTY - TRANSPORT
kity - pociąg
bus, dâvas - autobus
vagy - auto
väly - rower
härkias - przystanek
kitkias - dworzec kolejowy
buskias - dworzec autobusowy
kialie - bilet 
tag - statek, Schiff
kadas - samolot
▶️ GEDONT - PAŃSTWA
Etkas - Eteja
Polenkas - Polska [Polen/Polenkes - polski]
Doikas - Niemcy [Doikes - niemiecki]
Belgis - Belgia [Belgsa - belgijski]
Nežkralis - Niederlandy, Holandia [Nežkralsa - niderlandzki, holenderski]
Ykrainy - Ukraina [Ykrainam - ukraiński]
Italis - Włochy [Italsa - włoski]
Frankas - Francja [Frankes - francuski]
Ispanis - Hiszpania [Ispansa - hiszpański]
Heladis - Grecja [Heladsa - grecki]
Rosis - Rosja [Rossa - rosyjski]
Sevedkas - Szwecja [Sevedkes - szwedzki]
Norvegis - Norwegia [Norvegsa - norweski]
Irkas - Irlandia [Irkes - irlandzki]
Sevis - Szwajcaria [Sevsa - szwajcarski]
Ystäris - Austria [Ystärsa - austriacki]
Nogbritanis - Wielka Brytania [Britansa - brytyjski]
Portugaly - Portugalia [Portugalam - portugalski]
Tyrkis - Turcja [Tyrksa - turecki]
Romanis - Rumunia [Romansa - rumuński]
Nekrosis - Białoruś [Nekrossa - białoruski]
Estonkas - Estonia [Estonkes - estoński]
Slovenkas - Słowacja [Slovenkes - słowacki]
Madiarcas - Węgierski [Madiar, Madiarkes - węgierski] 
Syjetai Kandy N'amerieky, SCN - USA, Stany Zjednoczone [SK-Ameriekam - amerykański]
Sina - Chiny [Sinam - chiński]
Indis - Indie [Indsa - indyjski]
Braziel - Brazylia [brazielam - brazylijski]
▶️ CONTINENTŪ I VRAVENT - KONTYNENTY ITP.
Europä - Europa [Eūropeasam - europejski]
Europäsam Unis - Unia Europejska
Amerieky - Ameryka [Ameriecam - amerykański] 
Afrieke - Afryka
Australis - Australia
Antarktis - antarktyda
Azei - Azja
▶️ MÄIV I CASVAURIS - KSZTAŁTY I GEOMETRIA
mäiv - kształt
bear - koło
väizy - okrąg [väiza - okrągły, väize - krążyć]
rens - kwadrat
pad - kąt
dakpadnas - trójkát
ryispadnas - prostokąt
mäity - patyk, sztanga
näč - linia, wstęga, wstążka
käid - kula
gläid - słup
käik - lina
kaun (fieš) - linia (prosta)
blaskes - płaszczyzna
ezkas - powierzchnia
luit - belka
▶️ UNTOK - MATERIAŁY
aizok - metal [aezuk - metalowy]
drevok - drewno
kunstok - plastic
linsok - papier
kidrok - wodór
oxegok - tlen 
vekok - szkło
▶️ SKITY NEČES - CZĘŚCI CIAŁA
čes - ciało
galvy - głowa
atnas - mózg
paiser/sem - oko, oczy
rekas - nos
ryl - twarz
ram - ręka
kyrs - dłoń
leb - stopa 
točy - szyja
säiv - włosy
smig - paznokcie
tevog - tyłek
taiz - noga
um - palec
ryzok - mięśnie
rieč - serce
vaun - skóra
snyr - kość
sob - brzuch
nug - komórka
▶️ ITGALIS I ITSTAKIS - LINGWISTYKA I NAUKA JĘZYKÓW
ity - język
ky - słowo
menas - litera 
veskie - zdanie
menasis - alfabet
roity - głoska, dźwięk
kianroity - spółgłoska
voinroity - samogłoska
▶️ AXER - URZĄDZENIA
skašnas - telefon
drysnas - zamrażarka
kekie - mikrofalówka
baitie - piekarnik
▶️ PAŽY I NAŽY - JEDZENIE I PICIE
aimy  - jabłko
ryit - gruszka
lesteiž - brzoskwinia
nuteir - banan
bris - owoc
kasbris - ziemniak
keut - marchewka
bek - cebula
šeldom - warzywo
keup - tłuszcz
blyr - olej
miusblyr - masło
beig - jajko
teut - mięso
prean - mąka
preanneath - makaron
baūth - ciasto (surowe)
baūthnas - ciasto, tort, placek
baūthie - ciastko, ciasteczko
mius - mleko
čig - chleb
voidy - woda
kardokie - pomidor
sosy - sos
leukik, supy - zupa
kavie - kawa
čaj - herbata
sal - sól
fan - przyprawa
šeshady - śniadanie
axhady - lunch
galvhady - obiad
paghady - kolacja
inpažy - przekąska
drysie - lody
▶️ ANDAN I AUTA DAN AN SONŪ - MEBLE I INNE RZECZY W DOMU
sedie - krzesło
čiby - stół
sävkes - szuflada
ležkes - łóżko
ležnas - leżak
gačetas - kaloryfer
taidie - lampa
stuvkes - kontakt
nopaisty - okno
▶️ PRATVAMA I ALDGALSA KASPETONT - POJĘCIA FIZYCZNE I MATEMATYCZNE
maneity - pozycja
ykmaneity - przemieszczenie
rigesk - prędkość, velocity
faidesk - szybkość, speed
delinty - przyspieszenie
ryzy - siła
haulfraina - elektryczny
aizkity - magnes [aizkitis - magnetyzm, aizkita - magnetyczny, aizkituk - magnesowy] #magnet
nasrymy - oddziaływanie 
energis - energia
somrig šefty - ruch jednostajny
bryste - ciśnienie, nacisk
▶️ TAP - ZWIERZĘTA
bram - pies
kaik - kot
šain - wilk
šek - smok
blai - ptak
siedog - małpa
gil - ślimak
plyr - świnia
bryl - kura, kurczak [brylnas - kurnik]
zašy - wąż
daitop - gołąb
žiraf - żyrafa
elefant - słoń
▶️ ID VASSANTY - BEZ KATEGORII
astefty - sufit
asterom - konstelacja
astery - gwiazda
atis - umysł
atok - fakt
atsanty - rozprawka
avieskažy - protest
avry - prawda
axer - urządzenie
axis - firma
aznas - ściana
aš - dzień
baud - sztuka (jedna sztuka)
baun - spodnie
bery - ubranie
besy - cena
blat - liść
bluz - bluza
bor - moneta, pieniądz
bät - rok
dag - raz, mal
dan - rzecz
danie - temat
dauty - blok, klocek [daūte - blokować]
degšas - wakacje
dezesk - ilość
diety - zasada
dragy - droga
drasnas - komputer
drevkas - las
džel - towar
egsik - całka
fald - pole
fauie, fer - błąd
faukiaty - porażka, fail, Versagen
faurefty - koszmar, zły sen
fautaity - przestępstwo
finky - chwila
flar - zapał
flaris - pasja
flaut - trawa, zioło
fok - typ, ziom, gostek
frain - prąd
fras - wiatr
fyry - ogień
färd - okres (np. czasu)
gaižkäid - planeta
gald - głód [galda - głodny, galdeye - głodować, galdete - głodzi]
galvas - czapka
gasty - głos
gedy - państwo
glam - termin
glas - skrzydło
gräl - łańcuch
gäiz - kosmos
gäiztag - statek kosmiczny, rakieta
hadkias - kuchnia
hadyr - toaleta
haudetas - pojemnik
haulie - ładowarka
iekes - populacja, ludność
iesis - ludzkość
kainy - rodzaj
kas - kraj, ziemia
kaspis - pogoda
kavel - kawałek
kačy - cel [cathe - celować]
kečy - żart
kiansârty - umowa, Vertrag
kiezom - krzew, krzak
kitkias - dworzec
ky - słowo
kydy - problem
kyly - piekło
käily - niebo
lad - dach
lait - warstwa
lastaš - plecak
lebas - skarpetka
ležvisty - poziom
liny - strach
lisky - piosenka
loin - słońce
lois - pudło
mald - sens
man - miejsco
maut - śmieć, śmieci
mautnas - śmietnik
mašiny - maszyna
medy - środek, centrum
meskažy - wykaz, tabelka
mesležy - układ, layout
misky - spokój
molkias - kościół
mänog - ciekawostka
mänty - zainteresowanie
nadu - nadzieja
naknas - budzik
naskity - napięcie
navkes - drzwi
nemy - imię/nazwa
nesis - kolejność
niej - cud [nieja - cudowny]
nity - pokój
näul - futro
näulie - furras furry
paisok - film
parkiaty - sukces
paväsask - uważność
plid - wzór, Formel, formula
prat - świat
pregkas - pustynia
pres - sposób
pysitis - odpowiedzialność
päid - przestrzeń
radnas - kredka
rady - rysunek
rafmäity - miotła
rau - chmura
reukat - wzór, Muster, pattern
riezety - pochodna
roisis - muzyka
rok - lada, sklep
rošmäity - papieros
ryis - prawo, zasada
ryvganer, RG, paisie - telewizor
ryvganty - telewizja
ryznas - silnik
räity - zdrowie
saner - zeszyt
sanie - esej, wypracowanie
sannas - długopis
sapu - cisza
sarom - brama
sekes - grupa
senrymas - automat [senryma - automatyczny]
senvesky, aty - opinia {Et senvescoū, esv - moim zdaniem}
sield - pas, pasmo, streifen
sint - powód
skesy - obraz
skitsen- członek
skity - część
skäit - księżyc
smenkias - apteka
smenkiassen - aptekarz
smenty - lek
smetkias - sklep
smetrok - kasa
smidy - dowód
smienas - lekarz
snur - kabel
spatkias - hotel
spenom - ogrodzenie, Zaun
spyfty - duch
stag - kara [stagete - ukarać]
stakdan - przedmiot szkolny/uczelniany
stakie - lekcja
stakis - nauka
stedy - strona
stud - most
stuvnas - wtyczka
sug - ślad
syr - czas
syrog - moment
sân - dom
sâris - inteligencja
säilkias - toaleta
säim - los
taidy - światło
taizy - wstyd [teazeye - wstydzić się]
tevbery - majtki
tevsedy - miasto
toily - wojna
täižy - fakt
uen - para [uenete - zaparzyć]
vamis - rząd
vamsen - władca
vamy - władza
vardy - wartość
versis - wersja
verty - wiara
vilky - los
vraž - bóg
vuzy - dziura
väilsety - opcja, Wahlmöglichkeit
väizezy - talerz
yktočy - szalik
ylk - łyk
zier - plotka
zél - dusza
čeznity - salon, duży pokój
čezy - gość
čyi - kamień
šady - cień
šardie - pieniądze
šefty - ruch
šert - koszulka
ševaxer - urządzenie mobilne
žakäid - półkula, miska
žyngasety - przeznaczenie
žynkiaty - proces, Vorgang
žyntaity - postęp
žyrkas - podłoga
žyrnas - chodnik
