▶️ PREPOSITIS I VRAVENT - PREPOZYCJE ITP.
i - i 
det - a 
jiel - ani
chac - ale
meas - nawet
em - dla
o - już
je - jeszcze
umae - znowu
maès - nadal
aūris - o (about a topic)
aris, ac - tylko
aval - prawie
pris - czy
mich - zamiast
acos - pomimo
ceunaū - właściwie/eigentlich
naezaū - właśnie (w tym momencie)
son - za (np. za coś płacić)
avies - przeciw, przeciwko
rean - wobec
no - przez
id - bez
viscaū - może
cod, riv - też
valen - chyba
spaed - pewnie, najprawdopodobniej, wohl, probably
reuvan - dalej [reuv - daleki]
avresenca - prawdopodobny 
naū - jako
naūdis - w ogóle
michet - tylko (sondern)
dismich - a nie
for - według
ec - jakby, jak gdyby
ta - bo
bis - dopiero
seuram - podczas
on - za, pro {Axiu 40 daèv on chas. Ve bude €5 on baūd}
finccam - kiedy tylko, as soon as, sobald
tandauv - dopóki, tak długo jak, solange
▶️ SNERETCONT - FILLER WORDS
so... - nooo...
da.../dava...- ten teges
deus - cóż...
eustaū iteno - szczerze powiedziawszy
vesciu - mam na myśli, I mean
an saetu - w sensie 
▶️ S'SANETE SEURET - OPISYWANIE CZASU
seur - czas
ad - since / od
nae - until / do
beat aūris, jeun beat - rok temu, vor einem Jahr
an beat - w ciągu roku, innerhalb eines Jahres
no beat - za rok, in einem Jahr
beat jeunet/laset - rok wcześniej/później 
seuru nebeat - podczas roku 
tev da beat - w tym roku 
jeun - przed
las - po
greas - teraz
ranach - dzień (jako pora dnia)
chesnoc - rano
jeunjeach - przedpołudnie
jeach - południe
lasjeach - popołudnie
jeunnotu - wieczór
spatu - noc
raen - zaraz
▶️ DIUVASC - CZĘSTOTLIWOŚĆ [!4]
sacam - zawsze #!4
normaū - zazwyczaj #!4
diuvaū  - często #!4
seuru - czasem #!4
iliaū - nigdy #!4
citaū - ciągle #!4
necaū - rzadko #!4
▶️ SEUECES - JEDNOSTKI CZAS
beatpar - dekada
beat - rok
mesit - miesiąc 
chascansū - weekend
chas - tydzień 
ach - dzień
notu - noc
daev - godzina
daèzog - minuta
naèdit - sekunda
gavetu - jutro
pralies - wczoraj
▶️ MESIT - MIESIĄCE
deces - styczeń
dreusnas - luty
breznas - marzec
cevitces - kwiecień
mayus - maj
cardnas - czerwiec
julie - lipiec
▶️ ACH NECHAS - DNI TYGODNIA
scaètnas - poniedziałek
dinnas - wtorek
chasmed - środa
richnas - czwartek
gaurnas - piątek
thernas - sobota
cansces - niedziela
▶️ BEATSEUR - PORY ROKU
vencū - wiosna
lincū - lato
blatnas - jesień
lances - zima
▶️ PUGONT - POZDROWIENIA
Tauv ach ! - Dzień dobry!
Tauv nottot ! - Dobranoc! 
Nae s'mielse ! - Do widzenia! 
Asprathiu, sprathiu - Przepraszam
Giriu/gir's - dziękuję/dzięki
Cae ! - Hej! 
Tauveas samot (son betach) ! - Wszystkiego najlepszego (z okazji urodzin)! 
Ge destu ! - Nie ma za co!
Son raètu ! - Na zdrowie!
puge - pozdrowić
▶️ PREPOSITIS NECHEFTŪ I NEMANAÈTŪ - PREPOSITIONS OF MOVEMENT AND POSITION
alt - ponad
tev - pod
las - za czymś
jeun - przed
in - między
spen - dookoła
casp - poza
tac - obok
reues - prawo
lend - lewo
astu - góra
as - na górze czegoś
utu - dół

an    ¦ en    ¦ és  -    w 
ez    ¦ nas   ¦ zen -    na (horizontal)
az    ¦ nas   ¦ zan -    na (vertical) 
vé    ¦ vas   ¦ zav -    przy 
▶️ Ilość
dużo - rieu
więcej - rieun
najwięcej - rieus
mało - mieu
mniej - mieun
najmniej - mieus
camies - kilka 
▶️ Miscancelaneous
dis - nie
gen - tak
chan - trochę
veus - bardzo
