vaèle, ésseuce - wybrać, wybierać
fáere (nas) - czekać (na)
vaete - zostać
frese - usunąć
chepe - spać
bege - biegać, biec
roye - brzmieć 
creye - dotknąć, dotykać
caete - służyć
caetete - obsłużyć [caetetū - obsługa]
bande - uderzyć, bić
caūe - hauen, uderzyć, walnąć
core - prowadzić
neme - nazywać (się)
caje - pokazać
geuse - próbować
gaete - spaść, upaść
gade - gotować [gadū - danie]
liczyć - alde
niceye - zniknąć
seumeye - pojawić się 
chele - pomagać, pomóc
sane - pisać
ate (ja) - uważać/myśleć (że) 
gale - wiedzieć/znać
degale - dowiedzieć się/poznać
gane - widzieć 
saure - rozumieć 
rese - mieć
liorese - stracić
le - być
mete - mieć powinność 
dele - zostać
nore - robić
saye - znaczyć
deste - chcieć
sete - móc
desete - umożliwić
ciate - iść
peuse - wrócić
saege - używać
leteye - istnieć
letete - tworzyć
ite - mówić, powiedzieć 
cade - latać
defaureye - zaprzyjaźnić się
fende - znaleźć
seuce - szukać
mane - umieścić / place
cire - zgadnąć, zgadywać
mice - tulić
esplice - wytłumaczyć, tłumaczyć
ceame - czuć / odczuwać
este - wyjść, przestać
seane - wygrać
meane - interesować ciekawić
vere - wierzyć
nade - mieć nadzieję
pavease - uważać
pede - rzucić
gaūde - trzymać
pade - spadać
lise - czytać
sare - zamknąć
rase - przerwać
roele - kierować
ciale - jechać
sege - oglądać
steze - sprawdzić
roese - ratować, uratować
cave - wydawać się
cape - kryć
liocape - odkryć
crade - porządkować, ordnen [vascrade - zurodnen]
dreuse - mrozić
breuse - nacisnąć, przycisnąć [przycisk - breusnas]
naceye - obudzić się [nac - obudzony, na jawie]
nacete - obudzić
sabe - zepsuć się [liosabe - naprawić, sabae - zepsuty]
vame - rządzić
linte - spieszyć się
lande - skakać
minte - głaskać
lieve - ufać
danse - wiązać [zadansae - powiązany] 
cére - pytać
thase - wystarczyć
zaete - rozkazać/zamówić
feje - płynąć [fejtū - rzeka]
ruse - płynąć [ruscias - basen]
pearse - martwić się
nave - otworzyć, otwierać
bare - nudzić się
paese - patrzeć, wyglądać
vesce - mieć na myśli, meinen
sence - wydawać się, scheinen
dasceye - brakować
geare - zatrzymać
reume - działać
tharite - narzekać
nove - rozmawiać
rece - pachnieć
faūrece - śmierdzieć
save - udać się
lape - zdążyć
granete - chronić
vene - przyjść
vense - życzy
vaure - mierzyć
lathe - łączyć
smete - kupić
gaūle - ładować (kolokwialnie: dawać czadu, lecieć, szaleć, strzelać)
drase - rozwiązać
daje - podążać, follow, folgen
rade - rysować 
sede - siedzieć, posadzić
cande - stać, postawić
vese - wisieć, powiesić
leje - leżeć, położyć
stuve - stecken
darde - trwać
prade - płakać
gasete - określać
eucvaène - przekazać, umleiten (vaène - leiten)
driese - zachowywać się
driesete - traktować
depaese - zauważyć
charde - płacić
bere - nosić (ubrania)
fade - łamać 
canse - skończyć 
acaure - zgadzać się, zgodzić się
dacaure - pogodzić się
lioacaure - pokłócić się
paje - jeść
naje - pić
faye - celeborwać
bete - urodzić (się) 
taste - ciąć
lerse - zdecydować, decydować
roche - palić
lage - śmiać się
axe - pracować
prache - brać, wziąć
naspene - podarować
bere - nosić
asprate - przeprosić
frese - usunąć
stace - uczyć 
caute - żyć
gaène - mieszkać
rove - studiować
galete - informować 
thende - wysyłać/wysłać
jaule - życzyć
derese/nete - dostać
peusite - odpowiedzieć
pede - rzucić
ciale - jechać
mire - umrzeć
beuche - zabić
gelve - lubić [gelftū - przysługa, Gefallen]
praste - kochać
thede - nienawidzić
chane - zmienić/zmienić się
date - dać
esdate - wydać (pieniądze), ergeben
vriese - spędzać (czas)
cheve - ruszać (się) 
nare - słyszeć
narete - słuchać
mielse - spotkać się
ise - pozwolić
lioese - zakazać
cite - ciągnąć
cheye - musieć
chete - potrzebować
leūce - lać
unte - budować [untis - budownictwo, untū - budowa, untie - budynek]
smide - udowodnić
scache - dzwonić 
gite - wołać
jeure - chodzić, spacerować [jeurū - spacer]
seave - pchać
gaèle - podnieść [gaèlie - dźwignia, Hebel]
baete - piec
cece - falować, chwiać się
jaèpe - chwycić [jaèpu - uchwyt]
saèle - myć się
maène - czarować [maènis - magia]
pracheye (nasu) - zajmować się (czymś)
reute - badać
vede - kręcić
geate - złapać
daèse - przegrać
rale - bawić się [ralie - zabawka]
smene - leczyć
descesete - wyobrazić
taece - schalten [euctaece - przełączyć, entaece - włączyć]
ciene - montować, mocować
noece - please, sprawić przyjemność
scoete - ćwiczyć
naetieme - żałować
time - całować
caèbe - uśmiechać się [caèbū - uśmiech]
desence - okazać się
teuvvaène - polecić, rekomendować
sisceate - zaprosić
saène (aū) - marzyć (o)
meslare - decay, rozkładać się
nesete - następować
laègete - poprzedzać, proceed
bite - głaskać
éscaūe - wybuchnąć, eksplodować
gaūne - pomylić
dame - zamienić, wechseln
beuye (euc) - dbać, troszczyć się (o)
decore - kontrolować, sterować
espe - zarabiać
bude - kosztować
geve - woleć, preferować [geftū - preferencja]
onse - minąć [onstū - przeszłość]
pase - stać się
éscaje - reprezentować
